111111111111111111111111111111111111
11E0001000000000C00000C0000000000011
110001100000000000000000000000000011
110010100000000000000000000000000011
11P1111110C00C0000000000000000000C11
110000100000001110000000000000000011
110000100000010001000000000000000011
110000000000000011000000000000000011
110000000000000100000000000000000011
110000000000001111111000000000000011
110000000000000000000000000000000011
111111111111111111111111111111111111