111111111111111111111
100000000000000000001
1000E0000110C00000001
10P000100C01000000001
100000111101000000001
100000000000000000001
100000000000000000001
111111111111111111111
