111111
1E0001
111101
1PCCE1
111111