111111111111111111
111111111111111111
110000000000100011
11000p10000010c011
111111100100111011
110000000100000011
1100c000010000c011
110e0000010c000011
111111111111111111
111111111111111111