111111111111111111
111000111111111111
1100P0000000100011
11000010000010C011
111111100100111011
110000000100000011
1100C000010000C011
110E0000010C000011
111111111111111111
111111111111111111