111111111111111111
111000111111111111
1100P0000C00100011
110000100000100011
111111100100111011
110000000100000011
1111100E0100000011
110010000100000011
111111111111111111
111111111111111111