111111111111
11100p000111
110000000011
100000000001
100000000001
110000000011
111000000111
111111111111