111111111111
111000000111
110000000011
100000000001
10000p000001
110000000011
111000000111
111111111111