111111111111
10P000000001
100000000001
10E000000001
100000000001
1000C0000001
100000000001
100000000001
100000000001
100000000001
100000000001
111111111111