111111
1C0001
111101
1PCCE1
111111