1111111111111111111111111111
1000E000000000000000000000C1
1000000000000000000000000001
1000000000000000000000000011
100000000C0000000000000000C1
1000000000000000000000000011
1000000000000000000000000001
1000000000000000000000000001
1000000000000000000000000001
1000000000000000000000000001
1000000000000000000000000001
1000000000000000000000000001
1000000000000000000000000001
1P00000000000000000000000001
1111111111111111111111111111
